CCCCCCCCCCCCCCO
              O
              O
FFFFM  VM  VFFO
AAAAQ  WQ  WAAO
AAAAQ  WQ  WAAO
AAAAQ  WQ  WAAO
AAAAQ  WQ  WAAO
AAAAQ  WQ  WAAO