CCCCCCCCCCCCCCO
              O
              O
FFFFMFFFFFFVFFO
AAAAQ      WAAO
AAAAQ      WAAO
AAAAQ      WAAO
AAAAQ      WAAO
AAAAQ      WAAO