I            WO
             WO
             WO
Q    VBFFFFFFNO
Q    WAAAAAAAAO
Q  VBNAAAAAAAAO
Q  WAAAAAAAAAAO
Q  WAAAAAAAAAAO
TBFNAAAAAAAAAAO