AAAAAAAICCCCCCO
ICCCCCCP      O
Q             O
Q        VFFFFO
Q        WAAAAO
Q        WAAAAO
Q  VFFFFBNAAAAO
Q  WAAAAAAAAAAO
TFFNAAAAAAAAAAO